44444444444444444444444409094444
44444444444444444444444509094444
44090909090909090909090909094444
44090909090909090809090909094344
44090909090909090909080909090943
44090809090809090809090909090909
44090909090909090909080909090931
44090909090909090809090909093144
44090909090909090909090909094444
44443232323232323232323232323232
44444444444444444444444444444444
01
00
06
00
00
00
