44444444444444444444444444444444
44444444444444444444444444444444
44090909090909090909090909094344
44090902020202090909090909090943
44090909090909090202020909090909
44090902020202090909090909090909
44090909090909090202020909090909
44090902020202090909090909090931
44330909090909090909090909093144
44443232323232323232323209094444
44444444444444444444444409094444
03
00
00
02
00
00
-
1 03 1.0 0.5
-