00000000000000000000000000000000
00000000000000000000000000000000
00000909090909090909090909090000
00000906060606060606060606090000
00000906090907090908090906090000
09090906090709090909080906090000
00000906090909090909090906090000
00000906060606090906060606090000
00000909090909090909090909090000
00000000000000000000000000000000
00000000000000000000000000000000
00
07
00
00
00
00
-
0 01 0.1 0.5
-