00000000000000000000000000000000
00000000000000000000000000000000
00000909090909090909090909090000
00000909090909090909090909090000
00000909090909090909090909090000
00000909090906090909090909090909
00000909090909090909090909090000
00000909090909090909090909090000
00000909090909090909090909090000
00000000000000090900000000000000
00000000000000090900000000000000
04
00
00
00
00
00
-
0 01 0.1 0.5
-