00000000000000090900000000000000
00000000000000090900000000000000
00000909090909090909090909090000
00000909090909090909090909090000
00000909090909090909090909090000
09090909090906090909090909090000
00000909090909090909090909090000
00000909090909090909090909090000
00000909090909090909090909090000
00000000000000090900000000000000
00000000000000090900000000000000
00
05
05
00
00
01 04 09
-
2 01 0.1 0.5
-