00000000000000000000000000000000
00000000000000000000000000000000
00000909090909090909090909090000
00000906060909090909090606090000
00000909090909090909090909090000
09090909090909060609090909090000
00000909090909090909090909090000
00000906060909090909090606090000
00000909090909090909090909090000
00000000000000090900000000000000
00000000000000090900000000000000
00
05
00
00
00
01 04 09
-
2 01 0.1 0.5
-