44444444444444444444444444444444
44444444444444444444444444444444
44450909090909090943450909094344
45090908090809090909090908090944
09090909090909090909090909090944
09090908090809090909090908090944
09090909090909090909090909090944
33090908090809090909090908090944
44330909090909090931330909093144
44443232323232090944443232324444
44444444444444090944444444444444
00
06
00
01
00
00
-
0 04 1.0 0.5 13 07
-