44444444444444090944444444444444
44444444234445090944444444444444
44444445090909090944444444444444
44444509090909090944444444444444
44450909090909090943444444444444
09090909090909090909090909090944
32330909090909090909090909090944
44440909090909090909090909090944
44440909090909090909090909090944
44443232323232323232323232323244
44444444444444444444444444444444
00
02
03
00
04
00
-
0 01 1.0 0.5
-