00000000000000000000000000000000
00000000000000000000000000000000
00000909090909090909090909090000
00000909090909090909090909090000
00000909090909090909090909090000
00000909090906090909090909090000
00000909090909090909090909090000
00000909090909090909090909090000
00000909090909090909090909090000
00000000000000090000000000000000
00000000000000090000000000000000
00
00
00
00
00
01 04 09
-
0 01 0.1 0.5
-