00000000000000000000000000000000
00000000000000000000000000000000
00000909090909090906060606060000
00000909090909090909090606060000
00000909090909090909090906060000
00000909090909090909090909090909
00000909090909090909090906060000
00000909090909090909090606060000
00000909090909090906060606060000
00000000000000090900000000000000
00000000000000090900000000000000
08
00
00
05
00
00
-
0 01 0.1 0.5
-