00000000000000090900000000000000
00000000000000090900000000000000
00001010101010090910101010100000
00001009090909090910101010100000
00001009101010101010101010100000
00001009101010101010101010090909
00001009101010101010101010090000
00001009090909090909090909090000
00001010101010101010101010100000
00000000000000000000000000000000
00000000000000000000000000000000
04
00
07
00
00
00
-
1 04 0.1 0.5 08 08
-