44444444444444444444444409094444
44444444444444444444444509094444
09090909090909090909090909094444
09090909090909090809090909094344
09090909090909090909080909090943
09090809090809090809090909090909
09090909090909090909080909090931
09090909090909090809090909093144
09090909090909090909090909094444
44443232323232323232323232323232
44444444444444444444444444444444
01
00
00
00
00
